N	N
a	a
b	b
by	by
ch	ch
cl	cl
d	d
e	e
f	f
g	g
gy	gy
h	h
hy	hy
i	i
j	j
k	k
ky	ky
m	m
my	my
n	n
ny	ny
o	o
p	p
py	py
r	r
ry	ry
s	s
sh	sh
t	t
ts	ts
u	u
w	w
y	y
z	z
